000000000000000000000000000000
000000000000000002999999999999
000000000000000009999999999999
000000000000000009999999999999
000000000000000009999999999999
000000000000000009999999999999
000000001000000009999999999999
000000001000000009999999999999
000000001000000009999999999999
000000001000000000000000000000
000011111000000000000001000000
000010001000000000000001000000
000010001000000000000001000000
000010001111111111111111000000
000010000000100000000000000000
000010000000100000000000000000
000010000000100000000000000000
000010000000100000000000000000
000010000000111111111100000000
000010000000000000000000000000